WWWWWWW|WGBGGEW|WCWWGWW|WWWGGW |WGBGGWW|WGGGGEW|WWWWWWW
WWWWW  |WGEGWWW|WWBGGGW|WGGWGGW|WCEWBGW|WGGGGGW|WWWWWWW
WWWWWW |WEGEGW |WGGWGWW|WBBWGGW|WGGWBGW|WGGCGEW|WWWWWWW
WWWWWWW|WECWGEW|WGBWBGW|WGGGGGW|WGBWGGW|WGGWGGW|WWWWGEW|   WWWW
  WWWWW |WWWGGGW |WECBGGW |WWWGBEW |WEWWBGW |WGWGEGWW|WBGFBBEW|WGGGEGGW|WWWWWWWW